{
  "map": [
    [0, 0, 0, 0, 0, 0, 0, 0, 0, 0],
    [0, 3, 1, 1, 1, 1, 1, 1, 1, 0],
    [0, 0, 0, 0, 0, 0, 0, 0, 1, 0],
    [0, 1, 1, 1, 1, 1, 1, 1, 3, 0],
    [0, 1, 0, 0, 0, 0, 0, 1, 1, 0],
    [0, 1, 0, 1, 1, 3, 0, 0, 1, 0],
    [0, 1, 1, 1, 2, 1, 1, 0, 1, 0],
    [0, 1, 0, 1, 1, 1, 0, 0, 3, 0],
    [0, 1, 0, 0, 0, 0, 0, 0, 0, 0],
    [0, 1, 1, 1, 1, 1, 1, 1, 3, 0],
    [0, 0, 0, 0, 0, 0, 0, 0, 0, 0]
  ],
  "amount_food": 5,
  "player_moves": 0,
  "store": {}
}